{
  "entities": [],
  "width": 640,
  "height": 208,
  "createPlayer": true,
  "collisions": {
    "tiles": [
      [ 0,0,0,0,0,0,0,0,0,0,0,0,0,0,0,0,0,0,0,0, 0,0,0,0,0,0,0,0,0,0,0,0,0,0,0,0,0,0,0,0 ],
      [ 0,0,0,0,0,0,0,0,0,0,0,0,0,0,0,0,0,0,1,0, 1,0,1,1,1,0,1,1,1,0,0,0,0,0,0,0,1,0,0,0 ],
      [ 0,0,0,0,0,0,0,0,0,0,0,0,0,0,0,1,0,0,1,0, 0,0,0,0,0,0,1,0,1,0,0,0,0,0,0,1,1,1,0,0 ],
      [ 0,0,0,0,0,0,0,0,0,0,0,0,0,0,0,1,0,0,1,0, 1,0,1,1,1,0,1,1,1,0,0,0,0,0,1,1,0,1,1,0 ],
      [ 0,0,0,0,0,0,0,0,0,0,0,0,0,1,1,1,0,0,1,0, 1,0,1,1,1,0,0,0,0,1,0,0,0,1,0,1,1,1,0,0 ],
      [ 0,0,0,0,0,0,0,0,0,0,0,0,0,0,0,1,0,0,1,0, 1,0,1,1,1,0,0,0,1,1,0,0,0,1,1,0,1,0,0,0 ],
      [ 0,0,0,0,0,0,0,0,0,0,0,0,0,0,0,0,0,0,1,0, 0,0,0,0,0,0,0,1,1,1,0,0,0,1,1,1,0,0,0,0 ],
      [ 0,0,0,0,0,0,0,0,0,0,1,1,0,0,0,1,0,0,1,0, 0,0,0,0,0,0,1,1,1,1,1,1,1,1,1,1,1,0,0,0 ],
      [ 0,0,0,0,0,0,0,0,0,1,1,0,0,0,0,1,0,0,1,0, 0,0,0,0,0,0,0,0,0,1,0,1,0,1,0,0,0,0,0,0 ],
      [ 0,0,0,0,0,0,0,0,0,1,1,1,0,0,0,0,0,0,0,0, 0,0,0,0,0,0,0,0,0,1,1,1,1,1,0,0,0,0,0,0 ],
      [ 1,1,1,1,1,2,1,1,1,1,1,1,1,1,1,1,1,1,1,1, 1,1,1,1,1,0,0,0,0,1,0,1,0,1,0,0,0,0,0,0 ],
      [ 1,1,1,1,1,1,1,1,1,1,1,1,1,1,1,1,1,1,1,1, 1,1,1,1,1,0,1,1,1,1,1,1,1,1,1,1,1,0,0,0 ],
      [ 1,1,1,1,1,1,1,1,1,1,1,1,1,1,1,1,1,1,1,1, 1,1,1,1,1,0,0,1,1,1,0,0,0,1,1,1,0,0,0,0 ]
    ]
  }
}
