{
  "entities": [
    {
      "position": [240, 112],
      "components": [
        {
          "$type": "Solid",
          "width": 16,
          "height": 16,
          "defaultBehavior": true,
          "velocity": [-0.1, 0]
        }
      ]
    }
  ],
  "collisions": {
    "tiles": [
      [0,0,0,0,0,0,0,0,0,0,0,0,0,0,0,0,0,0,0,0],
      [0,0,0,0,0,0,0,0,0,0,0,0,0,0,0,0,0,0,1,0],
      [0,0,0,0,0,0,0,0,0,0,0,0,0,0,0,1,0,0,1,0],
      [0,0,0,0,0,0,0,0,0,0,0,0,0,0,0,1,0,0,1,0],
      [0,0,0,0,0,0,0,0,0,0,0,0,0,0,0,1,0,0,1,0],
      [0,0,0,0,0,0,0,0,0,0,0,0,0,0,0,1,0,0,1,0],
      [0,0,0,0,0,0,0,0,0,0,0,0,0,0,0,0,0,0,1,0],
      [0,0,0,0,0,0,0,0,0,0,0,0,0,0,0,1,0,0,1,0],
      [0,0,0,0,0,0,0,0,0,0,0,0,0,0,0,1,0,0,1,0],
      [0,0,0,0,0,0,0,0,0,0,0,0,0,0,0,0,0,0,0,0],
      [1,1,1,1,1,1,1,1,1,1,1,1,1,1,1,1,1,1,1,1],
      [1,1,1,1,1,1,1,1,1,1,1,1,1,1,1,1,1,1,1,1]
    ]
  }
}
